{
  "id": "ironwood_town",
  "width": 20,
  "height": 18,
  "tiles": [
    [1,1,1,1,1,1,1,1,1,1,1,1,1,1,1,1,1,1,1,1],
    [1,0,0,0,0,0,0,0,0,0,0,0,0,0,0,0,0,0,2,1],
    [1,0,0,0,0,0,0,0,0,0,2,2,2,0,0,0,0,0,2,1],
    [1,0,0,0,0,0,0,0,0,0,2,2,2,0,0,0,0,0,2,1],
    [1,0,0,0,0,0,0,0,0,0,2,2,2,0,0,0,0,0,2,1],
    [1,0,0,0,0,0,0,0,0,0,0,0,0,0,0,0,0,0,2,1],
    [1,0,0,0,0,0,0,0,0,0,0,0,0,0,0,0,0,0,2,1],
    [1,0,0,0,0,0,0,0,0,0,0,0,0,0,0,0,0,0,2,1],
    [1,0,0,0,0,0,0,0,0,0,0,0,0,0,0,0,0,0,2,1],
    [1,0,0,0,0,0,0,0,0,0,0,0,0,0,0,0,0,0,2,1],
    [1,0,0,0,0,0,0,0,0,0,0,0,0,0,0,0,0,0,2,1],
    [1,0,0,0,0,0,0,0,0,0,0,0,0,0,0,0,0,0,2,1],
    [1,0,0,0,0,0,0,0,0,0,0,0,0,0,0,0,0,0,2,1],
    [1,0,0,0,0,0,0,0,0,0,0,0,0,0,0,0,0,0,2,1],
    [1,0,0,0,0,0,0,0,0,0,0,0,0,0,0,0,0,0,2,1],
    [1,0,0,0,0,0,0,0,0,0,0,0,0,0,0,0,0,0,2,1],
    [1,2,2,2,2,2,2,2,2,2,2,2,2,2,2,2,2,2,2,1],
    [1,1,1,1,1,1,1,1,1,1,1,1,1,1,1,1,1,1,1,1]
  ],
  "interactables": [
    {
      "id": "ruined_smithy",
      "x": 6,
      "y": 4,
      "message": "The old smithy stands silent. Rebuilding it could revive Ironwood's craft."
    }
  ]
}
